FGGGGGGGGGGGGG
GGFFGWGWGFGFGG
WGGGGGGGGGGGGG
CGGGGGGGGGGGGG
WGGFGGGGFFGFFG
GGFWWCFGWWGWWG
GGWCCCWGWCCCWG
FGWCCCWGWCCCWG
GGWWCWCGWCCCWG
GGWGWGWGWCCCWG
GGGGGGGGCCCCWG
