GGGGGGGGGGGGGG
GGGGGGGGGGGGGG
GGGSGSSSGSGGGG
GSSWSSSSSWSSGB
BSWCWSSSWCWSSB
BWWCWWSWWCWWWC
CWCCCCWCCCCCWC
CWCCCCCCCCCCWC
CCWCWWCWWCWCCC
CCCCWCCCWCCCCC
WWWCWCCCWCWCWC
