GGGGGGGGGGGGGG
GGGMGGFFGGGGGG
GMMMMGFGGMMGGM
GGGGGGGGGGMMMR
MMMMMMGGGGGMRM
RRRMMGGGGMMGMG
MMMGGGGFGGGGGS
GGGGGGGFGGGSSS
GGGFGGGFFFGGFF
GGFGGGFGFFGGFF
GGGMMGFFGFFFGG
