GGGGGGGGGGGGGG
GGGGGGGGGGGRGG
GGFGMGGMGGGGGG
FGGGGGGGGGMGGG
GGGRGGGGGMMMGG
SGGGGGGGGMRMGG
FFFGGGGGGGMGGG
FGGGGGGGGGMGGF
GGGGMMGGGGGGFF
GGGGGGGGRGGGGG
GGGGGGGGGGGGGG
