GGGGGGGGGGGGGG
GGGGGGMMGMGGGG
GGGGGGGGMGGGGF
GGFGGGGGGGGGGG
GGGGGGGGGGGGGG
GGGGGGGGGGGGGG
GGMMGGGGGGGGGG
GGGGGGGGGGGFGG
GGGGGGGGGGGGGG
GGGGGMGMGGGGGG
GGGGGGGGGGGGGG
