SSSSSSSSSSSSSS
SSSSSSSSSSSSSS
SSSSSSSSSSSSSS
SSSDSGSGSSSSSS
SSGGDMMMDDSSSR
SMMGGMRRMGDSSS
SMRMGGMMMDDSSS
SSMSMGGDDDSSRS
SSMSSSDDSSSSSS
RSSSSSSSSSSSSS
SSSSSSSSSSSSSS
