GFFFFGFFFFFFFG
GFFFFGFFFFFFFG
FFFFFFGFFFFFGF
FFFGFFGFFFFGGF
FFFGGGGGFFFGGG
GGGFFFGGFFGFFG
FFFFFFFGGFFFFF
FFFFFFFGFFFFFF
FFFFFFFGFFFFFG
FFFFFFGFFFFFGG
GFFFFGGFFFFGGF
