GFGGGGGGFFFFFF
FFGFGGGGGFFFFF
FFFFFGGGFFFFFF
FFFFFGGFFFFFFF
FFFFFGGGFFFFFF
FFFFFGGGFFFFFF
FFFFGGGGGFGGGG
FFFFGGGGFFFGGS
FFFFFGGFFFGSSS
FFFFGGGGFFGSSS
FFFGGGGGFFGSSS
