MGGMGGGMMMGGMG
MGMMGGMGGGMGMM
GMMGGMGMMMGMMG
MMMGMMMMMMMMGM
DGMGGDDDDDDDGG
DDGDDDDDDDDDDS
DDDDDDDSDDDSSR
DDDSDSSSSSSSSS
SSSSSSSSSSSSSR
SSSSSSSSSSSSSS
SSSSSSSSSSSSSS
