SMGGGGGMGGGGGG
SMRRMSGGGGMGFF
SSMSSSSSDDGGGG
RSSSSSSSSDDDGG
SSSSSSSSSSDDGG
SSSSSSSSSSDDDG
SRSSSSSSSDDDDG
SRRSSSSSSDDGGG
SMGMSSSDDGGGGF
RGGGMGGGGMMGGF
MMRGGMMGGGGGFF
