DDDDDDDDDDDDDD
DDDMDMGGDDDDDD
GMDDMDMGGGDGGD
RGDDDDDDDGGDDG
MDDGGDDGDDGDGR
RDDMGGGRDDDDGR
DRDMGDRDDDDGGG
DDDMGDDDDMMMGD
DDDDMDDDDMRMGD
DDDDDDDDDDMDDD
DDDDDDDDDDDDDD
