GMGGGGGMMMGGSS
MGGGGGGGMGGGGG
GGGGGGGGGGGGGG
GGGGGGGWGGGGGG
GCWWGGWCWGGWWC
WCCWWCCCCCWWCC
WCCWCWWCWWCWCC
WWCCCCCCCCCCCW
GWCCCCCCCCCCCW
GGWCCCCCCCCCWG
GGWCCCCCCCCCWG
