GWCCCCCCCCCWGG
GCCCICCCICCCGG
GWCCCCCCCCCWGG
GWCCCCCCCCCWGG
GWWWWCCCWWWWGG
GGGGIGWGIGGGGG
GGGGGGGGGGGGGM
FFGMGMGGGFGMMR
FGGFMFMGFGGMRM
FGGGFFFFGGGGMG
GGGGGGGGGGGGGG
