GGGSSSSSSDGMMG
GMGSSSSSSDGRGG
MFGSSSSSDGGMGM
FMSRSSSSDGMGMM
FMSSSSSSDGRGGG
FMSSSSSSDGMMGG
FFSSRSSSDDGRGF
FFMSSSSSSDGMMG
MMMSSSSSSSGGRG
RMGMSSSSSSGGRM
MGFGSSSSSSGGMR
