DDDDDDDDDDDDGD
DGDDDDDMDDDGGD
DMGDDDGDGDDMGD
GRGDDDDDDDGRGD
MRGDDDDDDDGRMG
RRMGDDDDDGMRMG
MRRGDDDDDGMRRG
GMMGDDDDDDMMRG
GMGDGDDDDDGGRG
GGGDDDDDDDDGGD
DDDDDDDDDDDDGD
