GGGGWCCCWGGGGG
GFGGWCCCWGGWFW
WWGGWCCCWGGGGG
CCGGWWWGWGGWGW
CWGGFGFGFGGWWC
CWGGGGGGGGGCCC
WFGGFWGWFGGWCC
GGGGWCWWFGGWCC
GWGGCCCWFGGWWW
WFGGWWCWFGGFGG
GGGGGFCFFGGFGG
