GGWCCCCCCCWGGG
GGCCCCCCCCWGGF
GWWCCCCCCCWGGG
GWCCCCCCCCWCGG
GWCWWWCWCCWCWG
GWCCGGWGWWCCWG
GWCWGGGGGWCCWG
GGWGGGGGGGWWWG
GGGGGGGGGGGGGG
FGGGGMGMMGGGGF
FFGGMGGGGGGGGG
