CCCCWCCCWCCCCC
CCCCWCCCWCCWCC
CCCCWWCWWCCWCW
CWWWCCCCCWWCCC
CCCCWCCCWCCCCW
WWWCWWCWWCWWWS
SSWBWSWSWBWSSG
GGSBSGSGSBSGGG
GGGGGGGGGGGGGM
MGGGGGGGGGGGGG
GGGGGGGGGGGGGG
