FFFFFFFFFFFFFF
FFFFFFFFFFFFFG
FFFFFFFFFFFFFF
FGFFFFFFGGFFFF
GGGGGGFGFGFFFG
GFGGGGGFGGGGGG
GGGGGGGGGGGGGF
GGGGGMGGGGGGGG
GGGGGGGGGGGRMG
GMMMGGGGGMRGGG
GMRMMGGGGGGGGG
