GGGSSSSSSSGGGG
GGGSSSSSSGGGGG
FGGGSSSSSGGFGG
FFGGGSSSSGGGGG
GGGGGGGGGFFGGG
GGGGGGGGGGGGGG
GGGGGGGGGGGGGG
GFFGFFGMMGGGGF
FGGFFMGGGGGGGM
MRRMMMGGGFFGGM
MGGGGGGGFGGGMG
