GMGMGGGGGGGGFG
GGMMGGGFGGMGGG
GGFGGFGGGMGFGG
GGGGGGMGMGGGGG
GGGFGGGGGGGGGG
GGGGGGFGGGGGGF
GGFGFGGGFGGGFF
FFGGGFGFGGFFFF
FFGFGFGGGFGFFF
FFGGGFFFGGGGFG
GFGGFFFFGGGGFG
