MMMMMMMMMMMMMM
MRMRMRMRMMMRMM
MMMMMRMMMGMMMM
GGGMRMMGGMGGMR
GGGGMMGGGGGGGM
GGGGGGGGGGMGGM
GGGGGGGGRGGGGG
GGGGGGGGGGGGMM
GGGGGGGGGGGMRG
GGGGGGGGGGGGGG
GGGGGGGGGGGGGG
