GGGGGGGGGGGGGG
FFGFGGGFFGGGFF
FGFFGGGGRGGGFF
GGGGGGGDRDDDGG
GGGGRGGSDSSSGG
SSGGGSBSSSSSSS
SSSSSSBGSGDDSS
DDSSSDGGGFGGDD
GGDDDGGRGGGGGG
GGGGRFGGGGGGFF
FFGGFGGGGGGFFG
