MMRMGGGGGFFFFG
MRMMGGGGGGFGGF
MRMRMGGFGGFGFF
MMRMMMGGGFFFFF
MMMGMGGGFFGGFF
GGGGGGGGFFFGFG
MGGGGGGGGFFFGG
GGGGGMFFFFFFGF
GMMGMGGFFFGGGF
GGGGGFFFFGFGFG
FGGFFGFFFFGFGG
