SSSSSSSSSSSSSS
SSSSSSSSSSSSSS
DSSSSSSSSSSSSS
GDDSSSSSSSSSSS
GGDSSSSSRSSSSS
GDSRSSSRSSSSSR
GDSSSSSSSRSSRS
GDRSSSSSSSSSSS
GGGSSSSSSSSRSS
SGSSSSSSSSSSSS
SSSSSSSSSSSSSS
