GGGGGGGGGGGGGG
GGMMGGGGMGGMMG
GGGGGGGMMMGGGG
MMGGRGGMRRMGGM
RRMGGGMRRRMRGM
RRMGGGMMRMMGMR
RRMGGGGMRMGGMM
MMMGGRGMRMGGGM
GGGGGGGGMGGRGG
GGGMMGGGMGGGGG
GGMGGGGGGGMGGG
