SSSSSSSSSSSSSS
SSSSSSSSSSSSSS
SSSSSSSSSSSSSS
SSSSSSSSSSSRRS
SSSSSDDGSSSSSS
SDSDDDMMGSSSSS
DDDDDMMGGGSSSS
DDDDDGGMGGGGSM
MMDMGGGGMGGGMG
MMMGMMGGGGGGGM
GGGGGGMGGGGGGM
