GGGGGGGGGGGGGG
GMGGGGFFFFGGGF
MRMGGFGMFMFGGF
RMMGFGGGMGMGFF
MGGGGGGGGGGGGG
GGGGGIGWGIGGGG
GGWWWWCCCWWWWG
GGWCCCCCCCCCWG
GGWCCCCCCCCCWG
GGCCCICCCICCCG
GGWCCCCCCCCCWG
