GGGGGGGGGGGGGG
FFFGFGFGFGFGFF
GGGFGGFGFFGGFF
GGFFGGGGFFFGGG
FFGGGGGFFFFFGF
FFFGGFGFFFGGGF
GGFGFGFGGGGFFF
FGGGGGGFFGGFFF
FFFFFGGGFGFFFG
GGFGGFFGGFFFGF
GFGGGGFGFGFFGF
