GGGGGGGGGGGMMM
MMMMMMGGGMMDDD
DDDDDDGDGDDSSS
SSSSSSDSDSSSSS
SSSSSSSSSSSSSS
SSSSSSSSSSSSSS
SSSSSSSSSSSSSS
SDSDSSSSSSSDDD
DMDGDDDDDDDRRR
GGMGGGMMMMRGGG
GGGGGGGGGGGGGG
